1 1 1 1 1 3 3 3 3 3 3 3 3 3 3 3 3 3 3 3
1 1 1 1 1 1 1 1 1 1 1 1 1 1 1 0 0 0 0 3
1 1 0 0 0 0 1 1 1 1 1 1 1 1 1 1 1 0 0 3
1 1 0 0 0 0 1 1 1 1 1 1 1 1 1 1 1 1 1 3
3 1 0 0 0 0 1 1 1 1 1 1 1 1 1 2 2 2 1 3
3 1 1 1 1 1 1 1 1 1 1 1 1 1 1 2 2 2 1 3
3 1 1 1 1 1 1 1 1 1 1 1 1 1 1 2 2 2 1 3
3 1 1 1 1 1 1 1 1 1 1 1 1 1 1 1 1 1 1 3
3 1 1 1 1 1 1 1 1 1 1 1 1 1 1 1 1 1 1 3
3 1 1 1 1 1 1 1 1 1 1 1 1 1 1 1 1 1 1 3
3 1 1 1 1 1 1 1 1 1 1 1 1 1 1 1 1 1 1 3
3 1 1 1 1 1 1 1 1 1 1 1 1 1 1 1 1 1 1 3
3 1 1 1 1 1 1 1 1 1 1 1 1 1 1 1 1 1 1 3
3 1 1 1 1 1 1 1 1 1 1 1 1 1 1 1 1 1 1 3
3 1 1 1 1 1 1 1 1 1 1 1 1 0 0 0 0 0 0 3
3 1 1 2 2 2 1 1 1 1 1 1 1 1 1 0 1 1 1 3
3 1 1 2 2 2 1 1 1 1 1 1 1 0 1 1 1 0 1 3
3 0 0 2 2 2 1 1 1 1 1 1 1 0 0 0 0 0 1 3
3 0 0 0 0 1 1 1 1 1 1 1 1 0 0 0 0 0 4 3
3 3 3 3 3 3 3 3 3 3 3 3 3 3 3 3 3 3 3 3
END_MAP
END_ITEM
Boss,Elder Dragon,150,40,10,5,10,10,True
END_MONSTER
2
